4 3
09 02 02 02 02 02 02 02 02 02    02 02 02 02 02 02 02 02 02 02    02 02 02 02 02 02 02 02 02 02    02 02 02 02 02 02 02 02 02 09
07 00 00 00 00 00 00 00 09 00    00 00 00 00 00 00 00 00 09 00    00 00 00 00 00 00 00 00 09 00    00 00 00 00 00 00 00 00 09 04
07 00 03 06 00 00 00 00 00 00    00 00 03 06 00 00 00 00 00 00    00 00 03 06 00 00 00 00 00 00    00 00 03 06 00 00 00 00 00 04
07 00 04 07 00 00 09 09 09 09    00 00 04 07 00 00 09 09 09 00    00 00 04 07 00 00 09 09 09 09    00 00 04 07 00 00 09 09 09 04
07 00 05 08 00 00 00 00 09 00    00 00 05 08 00 00 00 00 09 01    01 01 05 08 00 00 00 00 09 00    00 00 05 08 00 00 00 00 09 04
07 00 00 00 00 00 00 00 00 00    00 00 00 00 00 00 00 00 00 01    01 00 00 00 00 00 00 00 00 00    00 00 00 00 00 00 00 00 00 04

07 00 00 00 00 00 00 00 00 00    00 00 00 00 00 00 00 00 00 01    01 00 00 00 00 00 00 00 00 00    00 00 00 00 00 00 00 00 00 04
07 00 00 00 00 00 00 00 09 00    00 00 00 00 00 00 00 00 09 01    01 00 00 00 00 00 00 00 09 00    00 00 00 00 00 00 00 00 09 04
07 00 03 06 00 00 00 00 00 00    00 00 03 06 00 00 00 00 00 01    01 00 00 00 00 00 00 00 00 00    00 00 00 00 00 00 00 00 00 04
07 00 04 07 00 00 09 09 09 09    00 00 04 07 00 00 09 09 09 01    01 00 01 01 01 01 01 01 01 01    01 01 01 01 01 01 01 01 01 04
07 00 05 08 00 00 00 00 09 00    00 01 05 08 00 00 00 00 09 01    01 00 05 08 00 00 00 00 09 00    00 00 05 08 00 00 00 00 09 04
07 00 00 00 00 00 00 00 00 00    00 01 00 00 00 00 00 00 00 01    01 00 00 00 00 00 00 00 00 00    00 00 00 00 00 00 00 00 00 04

07 00 00 00 00 00 00 00 00 00    00 01 00 00 00 00 00 00 00 01    01 00 00 00 00 00 00 00 00 00    00 00 00 00 00 00 00 00 00 04
07 00 00 00 00 00 00 00 00 00    03 00 00 00 00 00 00 00 09 01    01 00 00 00 00 00 00 00 09 00    00 00 00 00 00 00 00 00 09 04
07 00 00 00 00 00 00 00 00 03    00 00 09 00 00 00 00 00 00 01    01 00 03 06 00 00 00 00 00 00    00 00 03 06 00 00 00 00 00 04
07 00 03 06 00 00 01 01 01 00    00 01 04 06 00 00 09 09 09 01    01 03 00 07 00 00 09 09 09 09    00 00 04 07 00 00 09 09 09 04
09 01 04 07 00 00 00 00 00 00    00 03 00 00 06 00 00 00 07 01    01 04 00 07 00 00 00 00 09 00    00 00 05 08 00 00 00 00 09 04
09 01 01 01 01 01 01 01 01 01    01 01 01 01 01 01 01 01 01 01    01 01 01 01 01 01 01 01 01 01    01 01 01 01 01 01 01 01 01 09
