4 2
09 02 02 02 02 02 02 02 02 02    02 02 02 02 02 02 02 02 02 02    02 02 02 02 02 02 02 02 02 02    02 02 02 02 02 02 02 02 02 09
07 00 00 00 00 00 00 00 00 00    00 00 00 00 00 00 00 00 00 00    00 00 00 00 00 00 00 00 00 00    00 00 00 00 00 00 00 00 00 04
07 00 00 00 00 00 00 00 00 00    00 00 00 00 00 00 00 00 00 00    00 00 00 00 00 00 00 00 00 00    00 00 00 00 00 00 00 00 00 04
07 00 00 00 00 00 00 00 00 00    03 01 01 01 01 01 01 01 01 01    01 01 01 01 01 01 01 01 01 06    00 00 00 00 00 00 00 00 00 04
07 00 00 00 00 00 00 00 00 01    05 02 02 02 02 02 02 02 02 02    02 02 02 02 02 02 02 02 02 08    01 00 00 00 00 00 00 00 00 04
07 00 00 00 00 00 00 00 00 00    00 00 00 00 00 00 00 00 00 00    00 00 00 00 00 00 00 00 00 00    00 00 00 00 00 00 00 00 00 04
07 00 00 00 00 00 00 00 00 00    00 00 00 00 00 00 00 00 00 00    00 00 00 00 00 00 00 00 00 00    00 00 00 00 00 00 00 00 00 04
09 01 01 01 01 01 01 01 01 01    01 01 01 01 01 01 01 01 01 01    01 01 01 01 01 01 01 01 01 01    01 01 01 01 01 01 01 01 01 09
